10 10
##########
###ST##X##
#M#####X##
#######X##
####XXXX##
#X########
#X######C#
#XXX##F###
##########
######B###
