10 10
##########
######X###
###M###X##
##BST##X##
###CXXXX##
#X########
#X######C#
#XXX######
##########
##########
