10 10
##########
######X###
###M###X##
##BST##X##
##C#XXXX##
#XF#######
#X#F####C#
#XXX######
##########
##########
